0 *x** -> E 1

0 *E** -> X 2 

1 ***x -> S 3

1 ***S -> X 0

2 x*** -> N 0

2 N*** -> X 3

3 **x* -> W 2

3 **W* -> X 1